18
240 260
1 2 3 0 0 0 0 0 0 0 0 0 0 0 0 0 
9 9 2
1 0 0 1 0 0 1 0 0
0 0 0 0 0 0 0 0 0 
0 0 0 0 0 0 0 0 0
0 0 0 0 0 0 0 0 0
1 0 0 1 0 0 1 0 0
0 0 0 0 0 0 0 0 0
0 0 0 0 0 0 0 0 0
0 0 0 0 0 0 0 0 0
1 0 0 1 0 0 1 0 0
0 0 0 0 0 0 0 0 0
1 0 0 1 0 0 1 0 0
0 0 0 0 0 0 0 0 0
0 0 0 0 0 0 0 0 0
0 0 0 0 0 0 0 0 0
1 0 0 1 0 0 1 0 0
0 0 0 0 0 0 0 0 0
0 0 0 0 0 0 0 0 0
1 0 0 1 0 0 1 0 0


